BBBBBBBBBBBBBBBBBBBBBBBBBBBBBBBBBBBBBBBBB
B---------------------------------------B
B-----P--------------------%------------B
B---------------------------------------B
B---------------------------------------B
B---------------------------------------B
B-----%---------------------------------B
B--------%------------------------------B
B---------------------------------------B
BBBBBBBBBBBBBBBBBBBBBBBBBBB------------BB
B-----------------------BBB------------BB
B-----%--------------------------------BB
B--------------------------------------BB
B-----------------%-----BBBBBBBBBBBBBBBBB
BBB-------BBBBBBBBBBBBBBBBB
BBB-------BBBBBBBBBBBBBBBBB
BBB-------BBBBBBBBBBBBBBBBBB
BBB-----------------------BB
B--------------%----------BB
B-----------------%-----BBBBBBBBBBBBBBBBB
BBB-------BBBBBBBBBBBBBBBBB------------BB
B--------------------------------------BB
B--------%-----------------------------BB
B--------------------------------------BB
B--------------------------------------BB
B--------------------------%-----------BB
B----------------%---------------------BB
B----G---------------------------------BB
B--------------------------------------BB
BBBBBBBBBBBBBBBBBBBBBBBBBBBBBBBBBBBBBBBBB
