BBBBBBBBBBBBBBBBBBBBBBBBBBBBBBBBBBBBBBBBB
B---------------------------------------B
B-----P--------------------*------------B
B---------------------------------------B
B------*--------------------------------B
B---------------------------------------B
B-------------------------*-------------B
B---------------------------------------B
B---------*-----------------------------B
B---------------------------------------B
B----*------------------------*---------B
B-----------------------------*---------B
B-----------------------------*---------B
B-----------------------------*---------B
B-----*-----------------------*---------B
B-----------------------------*---G-----B
B-----*-----------------------*---------B
BBBBBBBBBBBBBBBBBBBBBBBBBBBBBBBBBBBBBBBBB