BBBBBBBBBBBBBBBBBBBBBBBBBBBBBBBBBBBBBBBBB
B---------------------------------------B
B-----P--------------------&------------B
B---------------------------------------B
B---------------------------------------B
B---------------------------------------B
B-------------------------&-------------B
B---------------------------------------B
B---------&-----------------------------B
B---------------------------------------B
B----&----------------------------------B
B---------------------------------------B
B---------------------------------------B
B---------------------------------------B
B-----&---------------------------------B
B--------&------------------------------B
B---------------------------------------B
BBBBBBBBBBBBBBBBBBBBBBBBBBB------------BB
------------------------BBB------------BB
------------------------BBB------------BB
------------------------BBB------------BB
------------------------BBB------------BB
BBBBBBBBBBBBBBBBBBBBBBBBBBB------------BB
B--------------------------------------BB
B--------&-----------------------------BB
B--------------------------------------BB
B--------------------------------------BB
B--------------------------&-----------BB
B----------------&---------------------BB
B----G---------------------------------BB
B--------------------------------------BB
BBBBBBBBBBBBBBBBBBBBBBBBBBBBBBBBBBBBBBBBB
